NO ./sprites/42/no.xpm
SO ./sprites/42/so.xpm
WE ./sprites/42/we.xpm
EA ./sprites/42/ea.xpm

F 101,67,33

C 135,206,235

1111111            1111111111111111
1000001    111111  1000000000000001
1000001    100001  1000000000000001
1000001    100001  1111111100000001
1000001    100001  1111111100000001
10000011111100001  1000000000000001
10000000000000001  1000000000000001
11111111000000001  1000000000000001
       1000000001  1000000011111111
       1000000001  1000000011111111
       1000000001111000000000000001
       100000000000000000N000000001
       1111111111111111111111111111
