NO ./sprites/dust2/no.xpm
SO ./sprites/dust2/so.xpm
WE ./sprites/dust2/we.xpm
EA ./sprites/dust2/ea.xpm

F 240,221,197
C 63,197,239

1111
10011                               1111111
1000111111111          11111111111111000001
1000000000001          10000100000000000001
1000100101001111111111110000100000000010001
101110000100000000000001000010011111001000111
100000000000000000000000000000010001111000001
100000000101111111100011111100100000000000101
100000000111      10001    100111111111000001
1101110001        11011    1011       1000111
 101110011111111111000111111001       10001
 101111111000000000001100000011       10001
 10000000101111111000010011111        10001
 10101010001     100001001    1111111110001
 10000000111     100001001    100000000000111
 111110111       100001001    100000000000001
 100000001       100001001    101100001000101
 101010101      11000000011111100100001000101
 100000001      10000000000000110111111111111
 100000001      111101111110000001
 100111111         101    10000001
 100100001         101111110000001
 100100001         100000000011111
 10000000111111111111111110001
 10000000000000000000000000001
 10000000000000N00000000000001
 11111111111111111111111111111
