NO ./sprites/test/no.xpm
SO ./sprites/test/so.xpm
WE ./sprites/test/we.xpm
EA ./sprites/test/ea.xpm



F 101,67,33




C 135,206,235









111111111111111111111111111111
100000000000000000000000000001111111111
100000000000000000000000000000000000001
100000000000000110000000000001111111111
100E00000000000110000000000001
100000000000000000000000000001111111111111111
100000000000000000000000000000000000000000001
100000000000000000000000000000000000000000001
100111111111111111111111111111111111111100001
1001                                   100001
1001                                   100001
1001                                   100001
1001                                   100001
100111                                 1000011111111111111111111
100001                                 1000000000000000000000001
111111                                 1111111111111111111111111
