NO ./sprites/wolf/no.xpm
SO ./sprites/wolf/so.xpm
WE ./sprites/wolf/we.xpm
EA ./sprites/wolf/ea.xpm

F 101,67,33

C 135,206,235

111111111111111111111111111111111111
1S0000000000000000000000000000000001
101111111110111111111111111101111101
101000000010000000000000001001000101
101000000010000111000000001001000101
101111111011111111100000001001000101
100000000000000000000000001001000101
101111111110111111111100111101000101
101000000000000000000000100000000001
101000000001111111111100111101111101
101111111110000000000000100000000001
100000000000000000000000111101111101
101111111111111111111111000000000001
100000000000000000000000111101111101
101111111110000000000000100000000001
101000000001111111111100111101111101
101000000000000000000000100000000001
101111111110111111111100111101111101
100000000010000000000000001001000101
101111111011111111111111111101111101
101000000010000000000000001001000101
101000000010000111000000001001000101
101111111111111111100000001001000101
100000000000000000000000001001000101
101111111110111111111111111101111101
100000000000000000000000000000000001
111111111111111111111111111111111111
